8 8
########
#@     #
# = =  #
#      #
# _ _  #
#      #
#      #
########
